------------- --- ----- ----------------
------------- --- ----- ----------------
-------------+--- ----- ----------------
-----       -   -         - -       ----
-----   --- -   ----------- -       ----
-----   + - +               -       ----
-----+-----------------------+---   ----
-----   --------------------- ---  !----
-----   ---------------------+----------
-----   ---------------       ----------
-----+----------------- ----------------
-----   --------------- ----------------
-----   --------------- ----------------
-----   --------------- ----------------
-----+----------------- ----------------
-----   + ------------- ----------------
-----   --------------- ----------------
-----   --------------- ----------------
-------+--------------- ----------------
-----   ---------------       ----------
-----   ---------------------+----------
-----   --------------------- ----------
-------+---------------------+----------
-----   -----------   +   -   -     ----
------- -----------   -   -   -     ----
      - -----------   -   +   +         
-----+- -------------------------   ----
-----   -------------------------   ----
---------------------------------   ----
----- + -------------------------   ----
----- - ---------------------------+----
----- - -------------------------   ----
----- - -------------------------   ----
----- - -------------------------   ----
-----+- -------------------------+------
----- -         -w  -       -       ----
----- --------- -   - --- - - ---   ----
-----         - +   + + - -     -   ----
-------------+---+---+- ----------------
------------- --- ---!- ----------------